
NO textures/cobblestone.png
SO textures/dirt.png
WE textures/piston_bottom.png
EA textures/polished_granite.png

F 220,100,0

C 225, 30, 0


111111111
100000001
1001D1001
100000001
1000N0001
111111111