
NO textures/cobblestone.png
SO textures/dirt.png
WE textures/piston_bottom.png
EA textures/polished_granite.png

F 220,100,0

C 225, 30, 0


1111111111111
1000000000001
1001D10000001
1000000000001
1000N00000001
1111111111111