
NO textures/cobblestone.png
SO textures/dirt.png
WE textures/piston_bottom.png
EA textures/polished_granite.png

F 194, 178, 128

C 3, 37, 76


1111111111111
1000000000001
1001D10000001
1000000000001
1000N00000001
1111111111111