
NO textures/cobblestone.png
SO textures/dirt.png
WE textures/piston_bottom.png
EA textures/polished_granite.png

F 255,250,250

C 25, 25, 112


111
101
10111
100W1
11111