
NO textures/cobblestone.png
SO textures/dirt.png
WE textures/piston_bottom.png
EA textures/polished_granite.png

F 220,100,0

C 225, 30, 0


111
101
10111
100W1
11111